1
30 25 150
666666666666666666666666666666
600000000000000000000000000006
600000000000000000000000000006
600000000000000000000000000006
600000000000000000000000000006
600000000000000000000000000006
600000666666660066666666000006
600000600000000000000006000006
600000600000000000000006000006
600000600000000000000006000006
600000600000000000000006000006
600000000000000000000000000006
600000000000000000000000000006
600000600000000000000006000006
600000600000000000000006000006
600000600000000000000006000006
600000600000000000000006000006
600000600000000000000006000006
600000666666660066666666000006
600000000000000S00000000000006
600000000000000000000000000006
600000000000000000000000000006
600000000000000000000000000006
600000000000000000000000000006
666666666666666666666666666666